# rats_and_mazes/amaze.txt
*********************
* *           *     *
* * * ******* *** * *
* * *       *     * *
* ***** *** ******* *
*     * *   *     * *
***** *** ***** *** *
*   *     *     *   *
* * ******* *** * ***
* *         *   *   *
* ***** * ********* *
*     * * *         *
***** * *** *********
*     *             *
*********************
